"ConfigurationId","TargetModule","RandomSeed","AlgorithmIterations","TotalTime","Coverage","Size","Length","FailingSize","FailingLength","PassingSize","PassingLength"
"Seed_Prob_0_3","pytutils.iters","1615569332855759388","255","121754672556","0.26666666666666666","8","67","3","16","5","51"
"Seed_Prob_0_7","pytutils.lazy.lazy_import","1615569816354701476","137","121835578035","0.41379310344827586","12","107","12","107","0","0"
"Seed_Prob_0_0","pytutils.meth","1615568902218919661","0","5033370624","1.0","2","10","2","10","0","0"
"Seed_Prob_0_2","pytutils.excs","1615569200592376823","173","122530121410","0.16666666666666666","5","134","0","0","5","134"
"Seed_Prob_0_1","pytutils.excs","1615569109830465611","182","121758329150","0.16666666666666666","3","70","0","0","3","70"
"Seed_Prob_0_3","pytutils.meth","1615569296791618585","0","5482838648","1.0","8","40","8","40","0","0"
"Seed_Prob_0_7","pytutils.mappings","1615569808126816997","109","122617757235","0.544","18","281","17","279","1","2"
"Seed_Prob_0_0","pytutils.sets","1615568907596818547","158","121218777651","0.6666666666666666","7","77","7","77","0","0"
"Seed_Prob_0_5","pytutils.meth","1615569535034293589","0","6164063009","1.0","5","29","5","29","0","0"
"Seed_Prob_0_8","pytutils.trees","1615569900278789464","190","121269198035","0.75","7","66","7","66","0","0"
"Seed_Prob_0_5","pytutils.iters","1615569534939898945","173","121404549413","0.26666666666666666","10","84","8","64","2","20"
"Seed_Prob_0_8","pytutils.urls","1615569926362786167","292","121522625032","0.75","5","19","5","19","0","0"
"Seed_Prob_0_7","pytutils.env","1615569832313191866","264","121305178909","0.5","6","64","4","49","2","15"
"Seed_Prob_0_3","pytutils.lazy.lazy_import","1615569350856312340","139","123090308712","0.45689655172413796","12","102","12","102","0","0"
"Seed_Prob_0_5","pytutils.excs","1615569585976857045","182","122138354368","0.16666666666666666","8","161","0","0","8","161"
"Seed_Prob_0_6","pytutils.env","1615569726857099181","206","122749207080","0.5","8","72","8","72","0","0"
"Seed_Prob_0_7","pytutils.meth","1615569791363651623","0","8245249781","1.0","8","37","8","37","0","0"
"Seed_Prob_0_9","pytutils.rand","1615570052584985607","0","4779290133","1.0","4","16","4","16","0","0"
"Seed_Prob_0_6","pytutils.python","1615569722254539896","206","123661754615","0.3","6","97","0","0","6","97"
"Seed_Prob_0_7","pytutils.iters","1615569790536600615","255","122269718281","0.26666666666666666","2","33","2","33","0","0"
"Seed_Prob_0_1","pytutils.tlds","1615569113014584328","214","121763952466","0.9166666666666666","10","58","10","58","0","0"
"Seed_Prob_0_9","pytutils.lazy.lazy_import","1615570071113241838","172","121457843211","0.43103448275862066","12","105","10","91","2","14"
"Seed_Prob_0_3","pytutils.env","1615569313200300381","239","121478629276","0.5","10","55","7","42","3","13"
"Seed_Prob_0_1","pytutils.lazy.simple_import","1615569114105070214","135","122416959563","0.6","10","222","0","0","10","222"
"Seed_Prob_0_9","pytutils.mappings","1615570062415097071","126","122066560153","0.64","19","278","15","221","4","57"
"Seed_Prob_0_3","pytutils.mappings","1615569348916002503","90","123303813661","0.624","16","348","15","342","1","6"
"Seed_Prob_0_1","pytutils.timers","1615569123822750270","0","8498453124","1.0","10","117","8","97","2","20"
"Seed_Prob_0_9","pytutils.env","1615570061687547699","280","121089282937","0.5","5","44","5","44","0","0"
"Seed_Prob_0_6","pytutils.log","1615569687475754560","207","121459184536","0.7647058823529411","10","79","9","76","1","3"
"Seed_Prob_0_1","pytutils.pythree","1615569080946921417","265","121259210928","0.42857142857142855","7","36","7","36","0","0"
"Seed_Prob_0_9","pytutils.files","1615570012972674828","164","121515258937","0.3448275862068966","10","144","9","125","1","19"
"Seed_Prob_0_8","pytutils.tlds","1615569963138618865","12","11236118172","1.0","5","36","5","36","0","0"
"Seed_Prob_0_8","pytutils.lazy.lazy_import","1615569957245747587","142","122868534770","0.43103448275862066","10","94","10","94","0","0"
"Seed_Prob_0_1","pytutils.python","1615569060816196637","141","122481941078","0.3","6","165","0","0","6","165"
"Seed_Prob_0_9","pytutils.path","1615570057414994649","152","122563335404","0.25","9","211","0","0","9","211"
"Seed_Prob_0_3","pytutils.pretty","1615569349723283081","142","121650263854","0.6470588235294118","9","55","9","55","0","0"
"Seed_Prob_0_4","pytutils.timers","1615569432967252476","0","8569212233","1.0","6","89","6","89","0","0"
"Seed_Prob_0_0","pytutils.lazy.lazy_import","1615568956583521722","152","121715111767","0.4224137931034483","11","102","11","102","0","0"
"Seed_Prob_0_1","pytutils.trees","1615569081551251210","187","121782038099","0.75","10","76","9","75","1","1"
"Seed_Prob_0_9","pytutils.urls","1615570065264894535","406","121123651516","0.75","2","10","2","10","0","0"
"Seed_Prob_0_4","pytutils.path","1615569409498266943","175","121471716170","0.25","6","129","0","0","6","129"
"Seed_Prob_0_0","pytutils.tlds","1615568956571699260","241","121052910604","0.9166666666666666","8","50","8","50","0","0"
"Seed_Prob_0_6","pytutils.excs","1615569709366163296","144","122388785670","0.16666666666666666","8","193","0","0","8","193"
"Seed_Prob_0_8","pytutils.files","1615569919621816839","160","122335241895","0.3448275862068966","9","95","9","95","0","0"
"Seed_Prob_0_5","pytutils.props","1615569585564549819","178","121138669526","0.6470588235294118","10","89","10","89","0","0"
"Seed_Prob_0_7","pytutils.pretty","1615569815000573325","205","121412861229","0.6470588235294118","10","47","10","47","0","0"
"Seed_Prob_0_0","pytutils.python","1615568958712634194","237","121580056535","0.3","4","59","0","0","4","59"
"Seed_Prob_0_4","pytutils.excs","1615569442908192759","263","121213273076","0.16666666666666666","2","30","0","0","2","30"
"Seed_Prob_0_2","pytutils.log","1615569195940496234","174","122396060087","0.7941176470588235","9","70","9","70","0","0"
"Seed_Prob_0_0","pytutils.env","1615568975249860644","167","121516582158","0.5","10","81","10","81","0","0"
"Seed_Prob_0_2","pytutils.env","1615569189105418450","309","121017669332","0.5","2","21","2","21","0","0"
"Seed_Prob_0_0","pytutils.log","1615568974810445377","148","121173162856","0.7941176470588235","9","76","9","76","0","0"
"Seed_Prob_0_2","pytutils.python","1615569193185984019","179","123110959576","0.3","5","110","0","0","5","110"
"Seed_Prob_0_3","pytutils.lazy.simple_import","1615569350828930847","191","122119960260","0.6","8","135","0","0","8","135"
"Seed_Prob_0_1","pytutils.env","1615569115966565692","209","123680281192","0.5","9","72","8","63","1","9"
"Seed_Prob_0_9","pytutils.timers","1615570065262903275","0","7705338625","1.0","10","117","7","87","3","30"
"Seed_Prob_0_6","pytutils.memo","1615569687198694654","282","121562358065","0.25","6","31","6","31","0","0"
"Seed_Prob_0_2","pytutils.files","1615569161989459709","204","121394253609","0.2413793103448276","9","81","7","68","2","13"
"Seed_Prob_0_3","pytutils.timers","1615569323531213572","0","6433592791","1.0","5","76","4","42","1","34"
"Seed_Prob_0_1","pytutils.mappings","1615569115236831646","97","122515587883","0.536","14","202","14","202","0","0"
"Seed_Prob_0_9","pytutils.lazy.simple_import","1615570071113395748","207","121609324457","0.6","4","112","0","0","4","112"
"Seed_Prob_0_7","pytutils.sets","1615569797077806572","180","121279298465","0.6666666666666666","9","69","9","69","0","0"
"Seed_Prob_0_6","pytutils.debug","1615569657195863739","0","7906073784","1.0","10","264","0","0","10","264"
"Seed_Prob_0_4","pytutils.files","1615569443359190122","164","121537261752","0.3103448275862069","11","127","9","98","2","29"
"Seed_Prob_0_1","pytutils.lazy.lazy_import","1615569098378621684","116","124231328727","0.4224137931034483","13","104","13","104","0","0"
"Seed_Prob_0_9","pytutils.tlds","1615570071113031463","4","9792873892","1.0","7","43","7","43","0","0"
"Seed_Prob_0_3","pytutils.tlds","1615569352167660856","222","121780219185","0.9166666666666666","8","65","8","65","0","0"
"Seed_Prob_0_5","pytutils.rand","1615569579772148004","0","5151576237","1.0","6","16","6","16","0","0"
"Seed_Prob_0_7","pytutils.debug","1615569772287393880","0","8436196454","1.0","7","158","0","0","7","158"
"Seed_Prob_0_6","pytutils.props","1615569727962867368","239","122402018391","0.6470588235294118","8","56","7","54","1","2"
"Seed_Prob_0_9","pytutils.excs","1615570054020313525","202","122341584069","0.16666666666666666","10","183","0","0","10","183"
"Seed_Prob_0_5","pytutils.sets","1615569557619280600","145","124021451158","0.6666666666666666","9","93","9","93","0","0"
"Seed_Prob_0_8","pytutils.timers","1615569969654669062","0","7601728873","1.0","7","96","6","82","1","14"
"Seed_Prob_0_7","pytutils.timers","1615569830272276886","0","7124170147","1.0","9","138","7","113","2","25"
"Seed_Prob_0_7","pytutils.lazy.simple_import","1615569815357873435","283","121229876033","0.6","2","41","0","0","2","41"
"Seed_Prob_0_6","pytutils.files","1615569670921252454","176","121626840042","0.3103448275862069","9","128","8","119","1","9"
"Seed_Prob_0_0","pytutils.pythree","1615568908149478654","235","121212145211","0.42857142857142855","7","45","7","45","0","0"
"Seed_Prob_0_2","pytutils.rand","1615569198606381276","0","4882798193","1.0","4","13","4","13","0","0"
"Seed_Prob_0_5","pytutils.debug","1615569557535847304","0","9290779461","1.0","3","64","0","0","3","64"
"Seed_Prob_0_8","pytutils.path","1615569898434493438","186","121975901957","0.25","8","168","0","0","8","168"
"Seed_Prob_0_7","pytutils.tlds","1615569805703275965","350","121088360500","0.9166666666666666","5","37","5","37","0","0"
"Seed_Prob_0_0","pytutils.iters","1615568908149848436","209","121443700771","0.26666666666666666","6","79","4","41","2","38"
"Seed_Prob_0_2","pytutils.lazy.lazy_regex","1615569205948128454","166","122157362022","0.6041666666666666","11","102","11","102","0","0"
"Seed_Prob_0_1","pytutils.rand","1615569115208226129","0","5681038917","1.0","5","11","5","11","0","0"
"Seed_Prob_0_3","pytutils.debug","1615569302295330847","0","7941646682","1.0","3","49","0","0","3","49"
"Seed_Prob_0_3","pytutils.sets","1615569332854691516","200","121765474852","0.6666666666666666","7","61","7","61","0","0"
"Seed_Prob_0_2","pytutils.mappings","1615569190434774791","114","122256705541","0.608","18","274","17","248","1","26"
"Seed_Prob_0_2","pytutils.debug","1615569192407601155","0","9622533288","1.0","6","139","0","0","6","139"
"Seed_Prob_0_4","pytutils.rand","1615569464564517758","0","4249177380","1.0","9","29","9","29","0","0"
"Seed_Prob_0_2","pytutils.props","1615569206411883494","187","121679344237","0.6470588235294118","9","74","9","74","0","0"
"Seed_Prob_0_0","pytutils.memo","1615568975405015817","228","121591105375","0.25","9","58","9","58","0","0"
"Seed_Prob_0_2","pytutils.memo","1615569195937905946","189","121253733949","0.25","9","51","9","51","0","0"
"Seed_Prob_0_0","pytutils.props","1615568975258389977","179","121418183281","0.6470588235294118","10","77","8","69","2","8"
"Seed_Prob_0_4","pytutils.mappings","1615569450265516717","129","123128666158","0.6","21","263","16","205","5","58"
"Seed_Prob_0_5","pytutils.memo","1615569580321188160","214","124070543044","0.25","10","48","10","48","0","0"
"Seed_Prob_0_5","pytutils.log","1615569585564263785","182","121699459805","0.7647058823529411","9","49","9","49","0","0"
"Seed_Prob_0_7","pytutils.lazy.lazy_regex","1615569814041840293","183","121683959051","0.6041666666666666","9","104","8","85","1","19"
"Seed_Prob_0_0","pytutils.debug","1615568907150124348","0","7038067227","1.0","4","62","0","0","4","62"
"Seed_Prob_0_4","pytutils.lazy.lazy_regex","1615569475157255649","156","121998377225","0.6041666666666666","11","83","9","75","2","8"
"Seed_Prob_0_4","pytutils.trees","1615569409850257341","161","121807105239","0.75","9","66","9","66","0","0"
"Seed_Prob_0_0","pytutils.pretty","1615568956583957951","161","121169621926","0.6470588235294118","10","61","10","61","0","0"
"Seed_Prob_0_6","pytutils.lazy.lazy_regex","1615569709402911383","156","121373648896","0.6041666666666666","10","92","10","92","0","0"
"Seed_Prob_0_4","pytutils.urls","1615569432969678311","216","122451491847","0.75","7","34","7","34","0","0"
"Seed_Prob_0_0","pytutils.lazy.simple_import","1615568960256887192","206","122258796505","0.6","6","116","0","0","6","116"
"Seed_Prob_0_6","pytutils.mappings","1615569687441087500","103","123052950806","0.592","19","308","19","308","0","0"
"Seed_Prob_0_1","pytutils.urls","1615569115978947883","307","123395322951","0.75","6","27","6","27","0","0"
"Seed_Prob_0_9","pytutils.trees","1615570071405726415","221","121316061028","0.75","8","81","8","81","0","0"
"Seed_Prob_0_8","pytutils.lazy.simple_import","1615569930512053239","211","123414769825","0.6","9","145","0","0","9","145"
"Seed_Prob_0_1","pytutils.path","1615569060816191009","302","121183521219","0.25","1","25","0","0","1","25"
"Seed_Prob_0_9","pytutils.python","1615570061577859133","139","121913751799","0.3","7","156","0","0","7","156"
"Seed_Prob_0_3","pytutils.lazy.lazy_regex","1615569365055681588","256","121528198844","0.6041666666666666","9","74","8","70","1","4"
"Seed_Prob_0_1","pytutils.files","1615569080945439374","192","121507494812","0.3448275862068966","9","102","9","102","0","0"
"Seed_Prob_0_9","pytutils.pythree","1615570013219703527","233","121251556374","0.42857142857142855","5","25","5","25","0","0"
"Seed_Prob_0_8","pytutils.pretty","1615569958907479714","139","122932778962","0.6470588235294118","10","65","10","65","0","0"
"Seed_Prob_0_6","pytutils.rand","1615569704773393249","0","5574997636","1.0","8","25","8","25","0","0"
"Seed_Prob_0_2","pytutils.urls","1615569187643805584","299","121101516640","0.75","3","16","3","16","0","0"
"Seed_Prob_0_5","pytutils.tlds","1615569584987809474","2","6426904947","1.0","6","39","6","39","0","0"
"Seed_Prob_0_8","pytutils.meth","1615569927905909795","0","6321658644","1.0","2","10","2","10","0","0"
"Seed_Prob_0_2","pytutils.trees","1615569193944452653","225","121308794123","0.75","8","62","8","62","0","0"
"Seed_Prob_0_8","pytutils.sets","1615569959140783610","183","123631154597","0.6666666666666666","8","70","8","70","0","0"
"Seed_Prob_0_5","pytutils.timers","1615569564781458189","0","6658154604","1.0","7","113","7","113","0","0"
"Seed_Prob_0_0","pytutils.trees","1615568975261376723","190","121183969013","0.75","7","58","7","58","0","0"
"Seed_Prob_0_7","pytutils.excs","1615569814999432540","259","121457121936","0.16666666666666666","5","73","0","0","5","73"
"Seed_Prob_0_4","pytutils.pretty","1615569475987328394","330","121376254526","0.6470588235294118","4","20","4","20","0","0"
"Seed_Prob_0_0","pytutils.urls","1615568975392683925","349","120990359378","0.75","4","20","4","20","0","0"
"Seed_Prob_0_4","pytutils.lazy.simple_import","1615569450207444230","271","121808781076","0.6","2","41","0","0","2","41"
"Seed_Prob_0_5","pytutils.lazy.simple_import","1615569589513087886","176","121336727664","0.6","3","106","0","0","3","106"
"Seed_Prob_0_4","pytutils.props","1615569467507331189","248","121205919882","0.6470588235294118","9","68","9","68","0","0"
"Seed_Prob_0_6","pytutils.lazy.simple_import","1615569713589843291","238","121598249614","0.6","2","40","0","0","2","40"
"Seed_Prob_0_0","pytutils.mappings","1615568965438178702","98","123000533480","0.552","19","320","18","307","1","13"
"Seed_Prob_0_8","pytutils.rand","1615569952688928871","0","6682116383","1.0","8","22","8","22","0","0"
"Seed_Prob_0_4","pytutils.debug","1615569456141651285","0","10372006561","1.0","2","38","0","0","2","38"
"Seed_Prob_0_6","pytutils.pretty","1615569713676448267","160","121667239939","0.6470588235294118","8","38","8","38","0","0"
"Seed_Prob_0_0","pytutils.lazy.lazy_regex","1615568956571772631","185","121452296645","0.6041666666666666","9","100","9","100","0","0"
"Seed_Prob_0_9","pytutils.sets","1615570012926386188","156","121180250916","0.6666666666666666","8","56","8","56","0","0"
"Seed_Prob_0_1","pytutils.iters","1615569079585325945","281","121366990140","0.26666666666666666","6","61","3","21","3","40"
"Seed_Prob_0_8","pytutils.lazy.lazy_regex","1615569989805978732","229","122786194279","0.6041666666666666","9","61","9","61","0","0"
"Seed_Prob_0_0","pytutils.rand","1615568956584216861","0","4353094163","1.0","9","26","9","26","0","0"
"Seed_Prob_0_8","pytutils.mappings","1615569955845212893","109","122954271876","0.6","16","274","16","274","0","0"
"Seed_Prob_0_4","pytutils.memo","1615569481213390910","214","121283744159","0.25","10","50","9","48","1","2"
"Seed_Prob_0_9","pytutils.debug","1615570061494661167","0","8654629459","1.0","2","40","0","0","2","40"
"Seed_Prob_0_1","pytutils.meth","1615569075960340344","0","6905261838","1.0","10","47","10","47","0","0"
"Seed_Prob_0_3","pytutils.excs","1615569364141514180","115","123527970763","0.16666666666666666","10","297","0","0","10","297"
"Seed_Prob_0_4","pytutils.iters","1615569454675253159","190","122198168036","0.26666666666666666","9","88","9","88","0","0"
"Seed_Prob_0_3","pytutils.log","1615569313377150912","235","121639980972","0.7647058823529411","8","47","8","47","0","0"
"Seed_Prob_0_9","pytutils.memo","1615570081630606942","236","121622824935","0.25","8","43","8","43","0","0"
"Seed_Prob_0_3","pytutils.memo","1615569310519696361","261","123916657517","0.25","8","35","8","35","0","0"
"Seed_Prob_0_9","pytutils.log","1615570041837530725","269","121521756655","0.7647058823529411","7","52","7","52","0","0"
"Seed_Prob_0_1","pytutils.props","1615569115965738490","234","123560908768","0.6470588235294118","9","63","7","55","2","8"
"Seed_Prob_0_7","pytutils.trees","1615569825989368583","185","121205169464","0.75","9","66","9","66","0","0"
"Seed_Prob_0_2","pytutils.pythree","1615569162055029107","263","121343374997","0.42857142857142855","6","35","6","35","0","0"
"Seed_Prob_0_5","pytutils.pretty","1615569583290350199","191","121253612051","0.6470588235294118","7","30","7","30","0","0"
"Seed_Prob_0_6","pytutils.urls","1615569694387279315","274","121326456413","0.75","6","32","6","32","0","0"
"Seed_Prob_0_7","pytutils.python","1615569823715037092","266","121157295290","0.3","3","38","0","0","3","38"
"Seed_Prob_0_9","pytutils.lazy.lazy_regex","1615570054020345580","175","121566430110","0.6041666666666666","11","105","11","105","0","0"
"Seed_Prob_0_2","pytutils.iters","1615569138310130878","179","121456487371","0.26666666666666666","10","94","10","94","0","0"
"Seed_Prob_0_6","pytutils.trees","1615569721712350572","190","123954358976","0.75","8","67","8","67","0","0"
"Seed_Prob_0_7","pytutils.pythree","1615569794259187652","174","122615460046","0.42857142857142855","9","58","9","58","0","0"
"Seed_Prob_0_4","pytutils.pythree","1615569438346875420","231","122540945765","0.42857142857142855","9","49","9","49","0","0"
"Seed_Prob_0_0","pytutils.files","1615568906179897421","184","121185458990","0.3103448275862069","10","105","10","105","0","0"
"Seed_Prob_0_6","pytutils.pythree","1615569661842789675","224","123761279810","0.42857142857142855","7","41","7","41","0","0"
"Seed_Prob_0_7","pytutils.memo","1615569814422460093","252","121394494233","0.25","6","32","6","32","0","0"
"Seed_Prob_0_3","pytutils.trees","1615569302273003483","163","121372239581","0.75","10","95","10","95","0","0"
"Seed_Prob_0_5","pytutils.python","1615569544146858569","227","121328489823","0.3","6","80","0","0","6","80"
"Seed_Prob_0_8","pytutils.python","1615569900496704132","155","122245407298","0.3","6","133","0","0","6","133"
"Seed_Prob_0_5","pytutils.pythree","1615569578890782958","190","121654852694","0.42857142857142855","9","58","9","58","0","0"
"Seed_Prob_0_8","pytutils.env","1615569968119404294","214","122590296313","0.5","7","49","5","32","2","17"
"Seed_Prob_0_7","pytutils.log","1615569825730786156","246","122214568009","0.7647058823529411","8","42","8","42","0","0"
"Seed_Prob_0_3","pytutils.pythree","1615569303905084476","338","121639349057","0.42857142857142855","4","25","4","25","0","0"
"Seed_Prob_0_8","pytutils.log","1615569962051908746","189","121543865929","0.7647058823529411","9","59","8","52","1","7"
"Seed_Prob_0_2","pytutils.lazy.simple_import","1615569219043640643","178","122421575523","0.6","1","40","0","0","1","40"
"Seed_Prob_0_6","pytutils.iters","1615569658823377488","294","121333823391","0.26666666666666666","2","37","1","16","1","21"
"Seed_Prob_0_2","pytutils.pretty","1615569207072296896","204","121834967191","0.6470588235294118","5","24","5","24","0","0"
"Seed_Prob_0_1","pytutils.pretty","1615569100825569048","180","124179671113","0.6470588235294118","10","56","10","56","0","0"
"Seed_Prob_0_3","pytutils.python","1615569302273086356","178","121726048477","0.3","8","143","0","0","8","143"
"Seed_Prob_0_5","pytutils.trees","1615569544156535735","140","121821295847","0.75","9","73","9","73","0","0"
"Seed_Prob_0_4","pytutils.log","1615569482323780066","178","122493658507","0.7647058823529411","9","51","8","44","1","7"
"Seed_Prob_0_9","pytutils.meth","1615570061404117135","0","5913608425","1.0","4","21","4","21","0","0"
"Seed_Prob_0_1","pytutils.debug","1615569053308633194","0","8145833684","1.0","4","82","0","0","4","82"
"Seed_Prob_0_3","pytutils.rand","1615569360445070173","0","4400276843","1.0","4","10","4","10","0","0"
"Seed_Prob_0_9","pytutils.iters","1615570061117986796","243","121527060314","0.26666666666666666","5","69","4","53","1","16"
"Seed_Prob_0_1","pytutils.sets","1615569094671161800","163","121940563829","0.6666666666666666","9","87","9","87","0","0"
"Seed_Prob_0_8","pytutils.excs","1615569956681136993","195","121744418239","0.16666666666666666","5","112","0","0","5","112"
"Seed_Prob_0_4","pytutils.python","1615569453942814522","159","122719085593","0.3","9","174","0","0","9","174"
"Seed_Prob_0_6","pytutils.tlds","1615569713699097266","262","121341500023","0.9166666666666666","6","47","6","47","0","0"
"Seed_Prob_0_0","pytutils.excs","1615568951067604450","417","121688164706","0.16666666666666666","2","10","0","0","2","10"
"Seed_Prob_0_4","pytutils.env","1615569430140239053","200","121591005126","0.5","10","53","8","47","2","6"
"Seed_Prob_0_6","pytutils.lazy.lazy_import","1615569713698569410","160","122087984478","0.45689655172413796","12","93","10","76","2","17"
"Seed_Prob_0_0","pytutils.timers","1615568974809912143","0","8168789908","1.0","9","86","6","47","3","39"
"Seed_Prob_0_4","pytutils.lazy.lazy_import","1615569461873632839","133","122627908146","0.43103448275862066","13","101","13","101","0","0"
"Seed_Prob_0_5","pytutils.mappings","1615569588210818558","110","123182556983","0.616","20","296","18","282","2","14"
"Seed_Prob_0_8","pytutils.pythree","1615569962779501605","204","125047517854","0.42857142857142855","8","35","8","35","0","0"
"Seed_Prob_0_5","pytutils.env","1615569585546398676","220","121490265124","0.5","10","101","8","93","2","8"
"Seed_Prob_0_0","pytutils.path","1615568958470018445","158","121828412678","0.25","9","176","0","0","9","176"
"Seed_Prob_0_7","pytutils.rand","1615569848024746612","0","9816598319","1.0","3","7","3","7","0","0"
"Seed_Prob_0_4","pytutils.tlds","1615569461871048454","256","121991812117","0.9166666666666666","8","46","7","43","1","3"
"Seed_Prob_0_8","pytutils.iters","1615569928102981584","167","121786452964","0.26666666666666666","10","85","9","82","1","3"
"Seed_Prob_0_2","pytutils.path","1615569189534018667","170","122571175407","0.25","3","97","0","0","3","97"
"Seed_Prob_0_2","pytutils.timers","1615569187665256391","0","7011613556","1.0","7","75","5","39","2","36"
"Seed_Prob_0_5","pytutils.lazy.lazy_import","1615569594989989865","163","122594659229","0.4482758620689655","14","137","12","121","2","16"
"Seed_Prob_0_6","pytutils.meth","1615569657179664177","0","5030423330","1.0","5","26","5","26","0","0"
"Seed_Prob_0_2","pytutils.tlds","1615569220572428404","190","123499384832","0.9166666666666666","10","71","10","71","0","0"
"Seed_Prob_0_1","pytutils.lazy.lazy_regex","1615569114104897718","202","121864372912","0.6041666666666666","9","75","8","70","1","5"
"Seed_Prob_0_3","pytutils.path","1615569300010382971","178","122566961216","0.25","10","187","0","0","10","187"
"Seed_Prob_0_5","pytutils.urls","1615569544157304708","277","121304171779","0.75","7","32","7","32","0","0"
"Seed_Prob_0_3","pytutils.files","1615569306377041539","193","121826330134","0.3448275862068966","10","106","7","76","3","30"
"Seed_Prob_0_8","pytutils.memo","1615569962731905088","252","121206408114","0.25","5","31","5","31","0","0"
"Seed_Prob_0_2","pytutils.lazy.lazy_import","1615569220572413403","119","123932279132","0.43103448275862066","15","130","15","130","0","0"
"Seed_Prob_0_5","pytutils.files","1615569550026704054","203","121672628629","0.3448275862068966","8","89","6","56","2","33"
"Seed_Prob_0_8","pytutils.props","1615569949605945804","189","121239633346","0.6470588235294118","8","72","8","72","0","0"
"Seed_Prob_0_7","pytutils.props","1615569832313220223","184","121541606294","0.6470588235294118","8","61","8","61","0","0"
"Seed_Prob_0_6","pytutils.sets","1615569659190352702","203","121198912368","0.6666666666666666","5","38","5","38","0","0"
"Seed_Prob_0_3","pytutils.urls","1615569340922689284","316","122761111996","0.75","7","35","7","35","0","0"
"Seed_Prob_0_5","pytutils.path","1615569543727355579","178","121324259635","0.25","8","166","0","0","8","166"
"Seed_Prob_0_8","pytutils.debug","1615569900509548297","0","6532972897","1.0","4","95","0","0","4","95"
"Seed_Prob_0_7","pytutils.files","1615569794249728909","197","122253162081","0.3103448275862069","11","118","8","91","3","27"
"Seed_Prob_0_6","pytutils.path","1615569724014435572","213","123915085763","0.25","3","70","0","0","3","70"
"Seed_Prob_0_4","pytutils.sets","1615569441092196446","212","121095205618","0.6666666666666666","5","43","5","43","0","0"
"Seed_Prob_0_5","pytutils.lazy.lazy_regex","1615569585993069608","200","121777741952","0.6041666666666666","11","100","10","92","1","8"
"Seed_Prob_0_7","pytutils.path","1615569826153232873","137","121705634163","0.25","10","245","0","0","10","245"
"Seed_Prob_0_6","pytutils.timers","1615569729411270334","0","8986093391","1.0","4","86","2","34","2","52"
"Seed_Prob_0_9","pytutils.pretty","1615570054017857128","245","121335501182","0.6470588235294118","7","42","7","42","0","0"
"Seed_Prob_0_2","pytutils.meth","1615569187926598967","0","4961470115","1.0","5","26","5","26","0","0"
"Seed_Prob_0_9","pytutils.props","1615570061625958149","200","121218634201","0.6470588235294118","7","61","7","61","0","0"
"Seed_Prob_0_1","pytutils.log","1615569123822846832","151","121883545836","0.7941176470588235","11","80","11","80","0","0"
"Seed_Prob_0_7","pytutils.urls","1615569826152087499","232","121329534110","0.75","7","44","7","44","0","0"
"Seed_Prob_0_2","pytutils.sets","1615569160642497483","181","122077670365","0.6666666666666666","8","67","8","67","0","0"
"Seed_Prob_0_4","pytutils.meth","1615569455347439915","0","6950050697","1.0","3","19","3","19","0","0"
"Seed_Prob_0_3","pytutils.props","1615569313372197492","238","121307276306","0.6470588235294118","7","52","6","43","1","9"
"Seed_Prob_0_1","pytutils.memo","1615569116550439986","194","122900575509","0.25","9","56","9","56","0","0"
